{
  "1": "1",
  "2": "2",
  "3": "3",
  "4": "4",
  "5": "5",
  "6": "6",
  "7": "7",
  "8": "8",
  "9": "9",
  "0": "0",
  "-": "-",
  "=": "=",
  "q": "/",
  "w": "׳",
  "e": "ק",
  "r": "ר",
  "t": "א",
  "y": "ט",
  "u": "ו",
  "i": "ן",
  "o": "ם",
  "p": "פ",
  "[": "]",
  "]": "[",
  "\\": "ֿ",
  "a": "ש",
  "s": "ד",
  "d": "ג",
  "f": "כ",
  "g": "ע",
  "h": "י",
  "j": "ח",
  "k": "ל",
  "l": "ך",
  ";": "ף",
  "'": ",",
  "z": "ז",
  "x": "ס",
  "c": "ב",
  "v": "ה",
  "b": "נ",
  "n": "מ",
  "m": "צ",
  ",": "ת",
  ".": "ץ",
  "/": ".",
  "!": "!",
  "@": "@",
  "#": "#",
  "$": "$",
  "%": "%",
  "^": "^",
  "&": "₪",
  "*": "*",
  "(": ")",
  ")": "(",
  "_": "_",
  "+": "+",
  "Q": "",
  "W": "",
  "E": "",
  "R": "",
  "T": "",
  "Y": "",
  "U": "וֹ",
  "I": "",
  "O": "",
  "P": "",
  "{": "}",
  "}": "{",
  "|": "|",
  "A": "שׁ",
  "S": "",
  "D": "„",
  "F": "",
  "G": "",
  "H": "",
  "J": "",
  "K": "לֹ",
  "L": "",
  ":": ":",
  "\"": "״",
  "Z": "",
  "X": "",
  "C": "לֹ",
  "V": "",
  "B": "",
  "N": "",
  "M": "",
  "<": ">",
  ">": "<",
  "?": "?"
}
