{
  "א": "",
  "ב": "б",
  "ג": "г",
  "ד": "д",
  "ה": "х",
  "ו": "в",
  "ז": "з",
  "ח": "х",
  "ט": "т",
  "י": "й",
  "כ": "к",
  "ל": "л",
  "מ": "м",
  "נ": "н",
  "ס": "с",
  "ע": "",
  "פ": "п",
  "צ": "ц",
  "ק": "к",
  "ר": "р",
  "ש": "ш",
  "ת": "т"
}
