{
  "א": "",
  "ב": "b",
  "ג": "g",
  "ד": "d",
  "ה": "h",
  "ו": "v",
  "ז": "z",
  "ח": "ch",
  "ט": "t",
  "י": "y",
  "כ": "k",
  "ל": "l",
  "מ": "m",
  "נ": "n",
  "ס": "s",
  "ע": "",
  "פ": "p",
  "צ": "ts",
  "ק": "k",
  "ר": "r",
  "ש": "sh",
  "ת": "t"
}
